Name Change - git config --global user.name "Name"

Email change - git config --global user.email "Email"

To view configuration Properties - git config --list

To view Help - git help

To view Help on Specific Command - git help specify-the-command

To view the current directory - pwd

To view the items in the directory - ls

To move to previous directory - cd ..

To initialize git in a directory - git init

To know the status of git project - git status

To add file to git - git add file-name

To add entire files in the directory to git - git add .

To commit the changes with message - git commit -m "message"

To see the commit changes log - git log

To see the commit changes log of particular person - git log --author="name"

To see the changes in the files - git diff

To compare stage area files and git repository files - git diff --staged

To delete a file - git rm file-name

To sync with the remote repository - git remote add origin "Repository-url"

To pull from remote repository - git pull origin branch-name

To push to remote repository - git push origin branch-name

To create a branch - git branch branch-name

To switch to a branch - git checkout branch-name 

To find out the no of branches - git branch

To merge the branch - git merge branch-name

To revert changes in staging area - git reset HEAD file-name

To revert the last commit - git reset HEAD~

To clone a project - git clone clone-url

To backout changes in working area - git checkout --file-name

To delete a no of files in directory - git rm -rf directory-name

To rename a file - git mv file-name new-file-name

To move a file - git mv file-name folder-name

To create an alias - git config –global alias.<short_cmnd> “long Cmnd”

To edit the configuration in git - editor-name ~/.gitconfig

To compare current working directory with repository - git diff head

To compare stage area and git repository - git diff --staged HEAD

To compare the commit - git diff commit-id commit-id

To rename a branch - git branch -m branch-name new-branch-name

To delete a branch - git branch -d branch-name 

To view the merge graph - git log --oneline --graph --decorate --all

To delete a branch - git branch -d branch-name

To rebase a branch - git rebase branch-name 

To abort a rebase - git rebase --abort

To continue rebase - git rebase --continue

To skip in rebase - git rebase --skip





